WE ./texs/west.xpm
EA ./texs/east.xpm
NO ./texs/north.xpm
SO ./texs/south.xpm

F 129,135,167
C 245,222,178

1111111
1000001
1010011  111
1000001  101
1000N0101101
110100000001
110010111111
1111111
